########################################################################
#@.........#..........A................................................#
#..........#...........................................................#
#..........#...........................................................#
#......................................................................#
#......................................................................#
#......................................................................#
#......................................................................#
#......................A...............................................#
#......................................................................#
#......................................................................#
#......................................................................#
#......................................................................#
#......................................................................#
#......................................................................#
#......................................................................#
#......................................................................#
#............................A.........................................#
#......................................................................#
#......................................................................=
########################################################################